.................................................................................................
.........................C........................................CCCCCCCCC......................
......................CCCCCCC............CCCC..................CCC..........CCCCCCCC..........CCC
.......CC...CC.CC..CCCC...CCCC.C.....CCCCCCCCCC..........CCCCC......CCCCCCCCCC.............CCC...
-------------------------------------------------------------------------------------------------