...........................................................................................................................................
..............................E....E............................ECCCCCCCCC......................E.......E........E.........E...C...C.......
..........................CCCCCCCCCC..................C.C.EECCCCCC..........CC...............CCCC.C.CCCCCCCEC.CCCCCC.E.C.CCCCCCCEEEC....E..
......E...E...E..E.....CE..E...........E...CCCEEECCCCCCECCCC...................EE.....EC.E.C........EE.....C.......CCCC...............CCC..
-------------------------------------------------------------------------------------------------------------------------------------------