.................................................................................................
..........................E................E......................CCCCCCCCC......................
......................CCCCCCCEC.CCCCCC.E.CCCC..................CCC....EE....CCCCC..........ECC...
.......CCEEECCECC..CCCC...CCCCCC.EEE.CCCCCCCCCC....E....CCCCC......CCCCCCCCCC..........CCCCC....C
-------------------------------------------------------------------------------------------------