........................................................................................
.....................................CCCC...............................................
................................CCCCC...................................................
...............E....CCC...CEEC.....E..........CC.E...CC.......CCC.E.CC.EC.....CC........
----------------------------------------------------------------------------------------