...........................................CCCCCCCCC..................................................................................................................................
.......................................CCCC.....................................................................CCCC..............CCCC......................................CCCCCCC...
.......C.CCCC........CCCC......CCCCCCCCC............CCCC...........C.................C...............CCCCCC.............cCCCC.........C.................................CCCCCC........
.C...CCCC......CC.........CCCC.C.....CCCCCCCCCC..........CCCCC..........CCCC......CC..........C...C.....CCCCCCCCCC..........CCCCC..........CCCC......CC..............C.....CCCCCCCCCC.
--------------------------------------------------------------------------------------------------------------------------------------------------------------------------------------