.......................
.......................
.......X...............
.....XXXX......XX......
-----------------------